50,50
*#################################################
#************************************************#
#*##############################################*#
#*#********************************************#*#
#*#*##########################################*#*#
#*#*#****************************************#*#*#
#*#*#*##################*###################*#*#*#
#*#*#*#****************#*#*****************#*#*#*#
#*#*#*#*##############*#*#*###############*#*#*#*#
#*#*#*#*#**************#*#***************#*#*#*#*#
#*#*#*#*#*##############*###############*#*#*#*#*#
#*#*#*#*#*#****************************#*#*#*#*#*#
#*#*#*#*#*#*############*#############*#*#*#*#*#*#
#*#*#*#*#*#*#**********#*#***********#*#*#*#*#*#*#
#*#*#*#*#*#*#*########*#*#*#########*#*#*#*#*#*#*#
#*#*#*#*#*#*#*#********#*#*********#*#*#*#*#*#*#*#
#*#*#*#*#*#*#*#*########*#########*#*#*#*#*#*#*#*#
#*#*#*#*#*#*#*#*#****************#*#*#*#*#*#*#*#*#
#*#*#*#*#*#*#*#*#*##############*#*#*#*#*#*#*#*#*#
#*#*#*#*#*#*#*#*#*#************#*#*#*#*#*#*#*#*#*#
#*#*#***#***#*#***#*##########*#*#*#*#*#*#*#*#*#*#
#*#*#########*#####*#********#*#***#*#*#*#*#*#*#*#
#*#*********#***#***#*########*#####*#***#*#*#***#
#*#*#####*#*#*#*#*#*#*#********#*****#####*#*###*#
#*#*#***#*#*#*#*#*#*#*#*###**###*###*******#***#*#
#*#*#*#*#*#*#*#*#*#*#*#*#E####*****#*#########*#*#
#*#*#*#*#*#*#*#*#*#*#*#S#****#*#####*#*******#*#*#
#*#*#*#*#*#*#*#*#*#*#*###*####*****#*#*#####*#*#*#
#*#*#*#*#*#*#*#*#*#*#*****#****#####*#*#***#*#*#*#
#*#*#*#*#*#*#*#*#*#*#####*####*#***#*#*#*#*#*#*#*#
#*#*#*#*#*#*#*#*#*#*****#*#****#*#*#*#*#*#*#*#*#*#
#*#*#*#*#*#*#*#*#*#######*######*#*#*#*#*#*#*#*#*#
#*#*#*#*#*#*#*#*#*******#*#******#*#*#*#*#*#*#*#*#
#*#*#*#*#*#*#*#*#######*#*########*#*#*#*#*#*#*#*#
#*#*#*#*#*#*#*#*******#*#*#********#*#*#*#*#*#*#*#
#*#*#*#*#*#*#*#######*#*#*#*########*#*#*#*#*#*#*#
#*#*#*#*#*#*#*******#*#*#*#**********#*#*#*#*#*#*#
#*#*#*#*#*#*#######*#*#*#*#*##########*#*#*#*#*#*#
#*#*#*#*#*#*********#*#*#*#************#*#*#*#*#*#
#*#*#*#*#*#########*#*#*#*##############*#*#*#*#*#
#*#*#*#*#***********#*#*#****************#*#*#*#*#
#*#*#*#*#############*#*##################*#*#*#*#
#*#*#*#***************#*****#**************#*#*#*#
#*#*#*#####################*#*##############*#*#*#
#*#*#*********************#*#****************#*#*#
#*#*#####################*#*#*################*#*#
#*#*********************#*#*#******************#*#
#*#####################*#*#*####################*#
#***********************#*#**********************#
##################################################

