15,5
###############
#S****#*#****##
**************#
##**##**##***##
**#***#***E*#*#